1111111111111112
1000000000000012
1000000000000012
1000010000000012
1000011111100012
1000000000100012
1000000000100012
111111111111111